SCREEN 1
Random Madness
RANDOM
SCREEN 2
Logik Horror
1301005500400500000010005500001
1430431440441540044000440010101
1555400410400454141404445010101
0555410045400454143004555010103
0010410445441041140400440010105
0404445005000001100050000011115
0404144444400004444400111011115
5404140500401015555510111011105
5434140440401041555140131011055
5444140140401044500440111010551
0111145045401004500410000015511
1000145040401004343410000015111
1111141340001004444400040045000
4444144441000001155100040455000
4000300001040404440440044555555
4000000041040404545404044555555
4000000041043404545414045455555
4600000000004004443414145043433
SCREEN 3
Never Turn You're Back On A Rock!
3105430004001003000055500000000
0140444414103000444444444444445
0140100005100300145555555155550
5140051055100003045444445444440
0141500551100100045551345555540
0141105511030001040103041555540
0141055114000111044444441151140
0140551144103011140055000131140
3145511440000016140444444444440
0145114431030000040400100110000
0145144133010010140444444444440
5145443313130003040004011400540
5140433333130003044404000404540
5140431313331033044404055454040
5145413331333333041104045454040
0140433133333133041000045454040
0140433333133333141511045454040
1000413333331313143511045554000
SCREEN 4
Falling Rock Zone
1101111000444144443044444444444
0114013411555515555504111115534
5140010041040414454004111105504
1003010550104414440004111111114
1404414404101414100404444414444
1400111004101414101404300100004
1401010104101414100404444144404
1410010014101414100400000000004
0100510001001414110444444044444
4110010011401414100014000000000
4001111100401414130404000000101
4400444004401414100004110444444
0001003000001414100404111414301
3100010000101414101004444414400
3331000101001414100004441113401
1333300000001414100400500000401
3313333001001414100004444444410
3333333330000060004000005550000
SCREEN 5
Avalanche!
0000400000000011100000000000000
1000400044444441444444400000000
0000400000040001100400000000000
0400400100040001100400000000000
0433400000040001100400411114444
0433400000040001100400400000003
0444400010040001100400404444444
0000000000000001000000004000000
4000000000000001000000000000000
0000011111111001000000001000000
0000113333331101000000001110000
0000011111111301444000000000000
0000011111111301004000000000000
0000011111111301004000000000000
0000033333333301004000000000000
0000000000000001004000044411000
0000000000000001004000040000000
6000000000000001554000043104003
SCREEN 6
Klaus' Revenge
1111111111111111111111144444444
0055555555500000000000340000000
0455555555442444444444440000000
0455555555444400000000000000000
5455555555555555555555555555555
5455555555555555555555555555555
5455555555555444544455555555555
5455555555555545554555555555555
5455555555555545554555555555555
5455555555555545554555555555555
5455555555555555555555555555555
5455555555555555555555555555555
5455555555555555555555555555555
5455555555555555555555555555555
5455555555555555555555555555555
5455555555555555555555555555555
5422222222222222222222220000000
6400000000000000000000000000000
SCREEN 7
Offsides
3410000000000000000041100000000
1010000000000000000043140000000
1110000000000000000044140000000
0110011111110111110000140000000
4010001111101111111000140001111
0010000313000000000000140001331
0410000010001111000000140001111
0000000010000034000000140001331
0044000010001111111000140001111
0000000010000111110000140004004
0000000030000000000000140000033
0000000000000000000000140000033
0000000000000000000000140000033
0000004444400000000000140000000
0000000000000010010000140000000
0000000000044444410000140444430
0000000000040100510000100400000
0000000000043005510060015430045
SCREEN 8
The Funnel
5500131113113133313113111310055
5554311131131111111311311134555
5555411311311133311131131145555
5555543113113111113113113455555
4455550431131133311311340555544
1144555504311111111134055554411
3111445555043131313405555441113
5133114455551111111555544113315
5155331144550153510554411335515
5155553311445156515441133555515
5155515533111155511113355155515
5100010000333005003330000100015
5100515000004105014000005150015
5100535000004355534000005350015
5100555000044555554400005550015
5150000000445553555440000000515
5350000004455555555544000000535
5550000044444444444444400000555
SCREEN 9
More Random Insanity!
RANDOM
